XXXXXXX
P     X
X XXXXX
X     X
XXXXX X
X     K
XXXXXXX
