XXXXXXXXX
P X   X X
X X X X X
X   X X X
X XXX X X
X X   X X
X XXXXX X
X       K
XXXXXXXXX
