XXXXXXXXX
P X     X
X X X X X
X   X X X
XXXXX X X
X     X X
XXXXXXX X
X       K
XXXXXXXXX
