XXXXXXX
P X   X
X X XXX
X X X X
X X X X
X     K
XXXXXXX
