XXXXXXXXXXXXXXXXXXXXX
P             X   X X
XXXXXXXXXXXXX X XXX X
X             X X   X
X XXXXXXXXX XXX X X X
X X   X X   X   X X X
X X X X X XXX XXXXX X
X   X X   X X X     X
X XXX X XXX X XXX X X
X X   X     X     X X
X X XXXXXXXXXXXXXXX X
X X     X       X   X
XXXXXXX X XXX XXX XXX
X   X   X   X     X X
X X X X XXX XXXXXXX X
X X   X   X   X     X
X XXXXXXXXXXX X XXX X
X X         X X X X X
X X XXXXX XXX X X X X
X       X       X   K
XXXXXXXXXXXXXXXXXXXXX
