XXXXXXXXXXXXXXXXXXXXXXXXXXXXXXXXXXXXXXXXXXXXXXXXXXXXXXXXXXXXXXXXXXXXXXXXXXXXXXXXXXXXXXXXXXXXXXXXXXXXXXXXXXXXXXXXXXXXXXXXXXXXXXXXXXXXXXXXXXXXXXXXXXXXXXXXXXXXXXXXXXXXXXXXXXXXXXXXXXXXXXXXXXXXXXXXXXXXXXXXXXXXXXXXXXXXXXXXXXXXXXXXXXXXXXXXXXXXXXXXXXXXXXXXXXXXXXXXXXXXXXXXXXXXXXXXXXXXXXXXXXXXXXXXXXXXXXXXXXXXX
P       X   X         X             X   X       X   X             X     X     X   X       X             X       X     X       X               X       X       X                 X                   X           X         X     X               X       X     X               X         X     X     X   X   X
XXXXX X XXX X X XXXXXXX XXX XXXXXXX X X X XXX X X X X XXXXXXX XXX X X XXX X X X X X XXX XXX XXXXXXX XXXXX X XXX X XXX X XXXXXXX XXXXXXXXXXXXX X X XXXXX X XXXXX X XXXXXXXXXXXXX XXX XXX XXXXXXXXXXX X XXXXX XXX X XXX XXX X XXX XXXXXXXXX XXXXX X XXXXX XXX X XXXXXXX XXXXXXX X XXXXX XXX X X XXX X X X X X X
X     X   X X X   X       X   X   X   X X   X X   X X   X     X   X X     X X   X X X X     X     X X     X X X   X   X   X     X           X   X       X   X   X     X   X   X   X X   X       X   X X   X X   X   X   X   X   X       X     X   X   X   X X       X X   X   X X     X   X X     X X X X X X
X XXXXXXX X X XXX X XXXXXXXXX X XXX XXXXXXX X XXXXX XXXXX XXXXX XXX XXXXXXX XXXXX X X XXXXXXX XXX X X XXXXX X XXXXX XXX X X XXXXX XXX XXXXX XXXXXXXXXXXXXXX X XXXXXXX X XXX X XXX XXX XXX XXXXX X XXXXX X X X XXXXXXX X X XXXXX X XXXXX XXXXX XXXXX XXXXX X XXXXXXX XXX X X X X X XXXXX XXX XXXXXXX X XXX X X
X     X X X X   X X   X X     X     X     X X X           X     X X X   X X X     X X       X   X X     X   X     X X   X X X     X   X   X X     X X   X   X       X X   X X   X X   X   X   X   X     X   X X     X X X X   X   X   X     X     X     X X       X     X   X X X         X X X   X X     X X
XXXXX X X X XXX X XXX X X XXX XXXXXXX XXX X X XXXXXXXXXXXXX XXXXX X X X X X XXXXXXX XXXXXXX XXX X XXXXXXX XXX XXXXX X XXX X XXXXXXX XXXXX X X XXX X X X X XXXXXXXXX X XXX X XXX X X XXX XXX X XXXXX XXXXXXXXX X XXX X X X X X X XXXXX XXXXX XXXXX X X XXX X XXXXX XXXXXXXXXXX X XXXXXXXXXXX X X X X X XXXXX X
X     X       X X   X   X X   X   X   X X   X         X X   X     X   X X X       X   X     X   X         X   X     X X   X         X     X   X   X   X X     X     X X   X X X   X X X X X X X             X X X X X X X X X X X   X     X     X X X   X X X   X         X   X   X         X   X   X     X X
X XXXXXXXXXXXXX X XXXXX X X XXX X X XXX XXXXXXXXXXXXX X X XXX XXX XXXXX X XXXXXXX XXX X XXX X XXXXXXXXXXXXX X X XXXXXXX XXXXXXXXXXXXX XXXXXXXXX XXXXXXX XXXXX X XXXXX X XXX X XXXXX X X X X X X XXXXX XXXXX X X X X XXX XXX X XXX X XXX X XXXXX X X XXX X X XXX XXXXXXXXX XXXXXXX X XXX XXXXX XXXXXXXXXXXXX X
X       X       X X   X X X   X X   X   X             X       X X     X   X   X     X X X   X       X   X   X X   X   X       X               X       X   X X X X   X X   X     X   X X X   X   X   X   X   X   X X   X   X X     X   X X     X X X   X X X           X   X     X X   X X   X       X     X X
X XXXXX X XXXXXXX X X X X X XXX XXXXX X X XXXXXXX XXXXXXXXXXXXX XXXXX XXX XXX X XXXXX X X XXXXXXXXX X XXX X XXXXX X X XXX XXX X XXXXXXXXXXXXX XXXXXXX X X X X X X X X XXX XXXXX X XXX X XXXXX XXX X XXXXX XXXXXXX XXX X X X XXXXXXXXX XXXXXXX X X XXX X X XXXXXXXXXXX X XXX XXX X XXX XXX X XXXXXXX X XXX X X
X X X   X       X X X   X X X   X   X X X   X   X X       X X           X X   X   X   X X X         X X   X     X   X X   X   X X           X       X X X X X   X X X   X X     X   X X     X X   X X   X X   X     X X X   X       X X     X X   X X X   X         X X   X X X   X X X   X X   X   X X X   X
X X X XXX XXXXXXX X XXXXX X X XXX X X XXXXX X X X X XXXXX X X XXXXXXXXXXX X X XXX X XXX X X XXXXXXXXX X XXXXX X XXXXX X XXX XXX XXXXX XXXXX X XXXXXXX X X X XXXXX X XXX X X XXXXX X X XXXXX XXX XXX X X X XXX X X XXX X XXXXX XXX XXX X XXX X XXXXX X XXXXX XXXXXXX XXXXX X X XXXXX X X XXX XXX X XXX X XXX X
X   X     X     X       X X X X   X X X     X X   X X X   X     X X     X X X X   X X   X X X         X X     X     X X   X   X     X X     X       X   X   X X   X   X X   X     X X     X   X   X X X X X   X X   X X   X X   X   X   X   X       X   X     X   X   X   X         X X X X   X X X   X     X
XXX XXXXXXX XXX XXXXXXXXX X X X XXX X X XXX XXXXX X X X XXXXXXX X X XXX X X XXX X X XXX XXX X XXX XXX X X XXXXXXXXX X X X XXXXXXXXX XXX XXX XXXXXXX XXXXXXX X X X XXXXX X XXXXXXXXX XXX XXXXX XXX X X X X X XXX XXX X XXX X X XXXXX XXXXX XXX XXX XXXXX X XXX X X XXX X X XXXXXXX XXX X X XXX X X X XXXXXXX X
X X X   X   X             X X   X     X X   X   X X   X X     X   X   X   X X   X X     X   X   X X   X X X   X     X X X   X     X   X X X     X X   X   X X   X X     X           X   X         X   X   X       X X X   X   X   X     X X     X     X X   X X X   X X X   X     X   X   X X X     X     X X
X X X X X XXXXXXXXXXXXXXXXX X XXXXXXXXX XXXXX X XXXXX X X XXX XXXXXXX XXXXX X XXX XXXXX X XXXXXXX XXXXX X X X X XXXXX XXXXX X X XXXXX X X XXXXX X X XXX X X XXXXX X XXX XXXXXXXXXXXXX XXX XXXXXXXXXXXXXXXXX XXXXXXX X XXX XXXXX X XXXXX X XXXXXXXXX XXX XXX X X XXX X X XXXXX XXXXX XXXXX X X XXXXXXX XXX X X
X X X X X     X             X X         X     X     X X X X X X         X   X X     X   X   X   X   X   X X X     X X X   X X X     X   X     X   X X   X   X     X X X X   X             X     X           X X   X X   X   X   X     X X   X     X     X   X X X   X X X     X   X         X X         X X X
X X X X XXXXX XXX XXXXXXXXXXX X XXXXXXX X XXXXXXXXX X X X X X X XXXXXXX X X X XXXXXXX XXXXX X X XXX X XXX XXXXXXX X X X X X X XXXXX XXXXX X XXXXX X X XXXXXXX XXX X X X X X XXXXXXXXXXXXXXX XXX X XXXXXXXXX X X X X XXX XXX X X XXXXX X XXX X XXX X XXXXX XXX X X XXX X X XXXXXXX XXXXXXXXX X X XXXXXXXXX X X
X   X X   X X   X X       X   X   X     X         X   X     X     X   X   X X X       X   X   X X   X X X X     X   X   X   X     X     X X       X X X     X X   X X   X X                 X   X X       X   X X X   X   X   X X   X     X     X X     X X   X X X   X X     X   X     X   X   X   X X   X X
X XXX XXX X XXX XXX XXXXX X XXXXX XXXXXXX XXXXXXXXXXXXXXXXX XXXXXXX X X XXXXX X XXXXXXX X XXXXX X XXX X X X XXX XXXXXXXXXXX XXXXX X XXX X XXXXXXXXX X XXX X X XXXXX XXXXX XXXXXXXXXXXXXXXXXXX XXX X XXXXX X XXX X XXX XXX XXXXXXX X XXXXXXX XXXXX XXXXX XXX XXX X X XXX XXXXX X XXX XXX XXX XXXXX X X X XXX X
X X   X   X   X   X X   X   X   X       X X   X         X X   X     X X X     X X X     X       X X   X X   X X   X     X   X     X   X X     X   X X X   X X     X     X X         X   X X   X   X X   X X X   X     X   X     X X       X X   X X   X X   X   X X   X   X   X   X X     X X     X   X X   X
X X X X XXXXX XXX X X X XXXXXXX XXXXX X X X X X XXXXXXX X X XXX XXXXX X X XXX X X X XXXXXXXXXXXXX X XXX XXXXX XXX X XXX X XXX XXXXXXX XXXXX XXX X X X X XXX XXXXX XXXXX X XXX X XXX X X X X XXX XXX X X X XXX XXXXX XXX XXX XXX X XXXXXXX XXX X X X XXX X XXX XXX XXX XXX X XXXXX X XXXXX X XXX XXX XXX X XXX
X X X X         X   X X         X   X X X X X   X   X   X   X   X   X X X X   X   X   X           X   X         X   X X     X X     X       X   X   X X   X       X   X X   X X   X   X   X   X X   X X X   X     X X   X   X     X           X X X     X X   X     X   X         X   X X X X   X   X   X   X
X XXX XXXXXXX XXXXXXX XXX XXX XXX X X X X X XXXXX X X XXX XXX XXXXX X X X XXX XXX XXX XXX X XXXXXXXXX XXX XXXXX XXXXX XXXXXXX X XXX XXXXXXXXX XXXXX X XXX XXXXXXX XXX X XXX XXX X XXXXXXXXXXX XXX XXXXX XXX X XXX XXX XXXXX XXXXX XXXXXXXXXXXXX X X XXXXX X X XXXXXXXXX XXXXXXXXX XXX X X X X XXX XXX XXXXX X
X   X       X X     X X   X X X   X X X   X     X X X X     X X     X X X   X   X X X   X X         X     X     X       X     X   X       X   X     X X   X   X     X X   X   X X     X     X     X     X X X X   X   X     X   X X     X     X   X       X X X       X         X   X X   X   X X X X X   X X
XXX XXX XXX XXX XXX X X XXX X X XXX XXX XXXXXXX X X X XXXXXXX X X XXX XXXXX XXXXX X XXX XXXXXXXXX X XXXXXXX XXXXXXX X X X XXXXXXX XXX XXX X XXXXXXX X X XXX X XXXXX X XXX XXX X XXXXX X XXX XXXXXXX XXX X X XXX XXX XXX X XXX X X X XXX X X XXXXXXXXXXXXXXX XXX XXX X XXXXXXXXX X XXX X XXXXXXX X X X X X X X
X X   X   X       X   X X   X X X X   X     X X X X X   X     X X           X   X   X X X         X       X X     X X X X X         X X   X       X X   X   X     X     X   X X X   X   X   X   X   X X X X   X   X   X X     X X X X   X X         X       X   X   X   X     X X X   X X   X   X   X X X   X
X XXX XXXXXXXXXXXXX XXX X X X X X XXX XXXXX X X X X XXX X XXXXXXXXXXXXXXXXXXX X XXX X X X XXXXXXXXXXXXXXX X X XXX XXX X X XXXXXXXXXXX XXXXX XXXXX X XXX X XXXXXXX XXXXX XXX X XXX X XXXXX X X X XXX X X X XXX X X XXX X XXXXXXX X X X XXXXXXXXX X XXX XXX XXX XXX XXXXX X XXX X X X XXX XXX X X XXX X X XXXXX
X   X     X       X   X X X   X X   X     X   X X X   X   X   X             X X       X X   X       X     X X   X     X X X         X X   X   X   X   X X   X     X   X   X X     X   X   X   X     X     X   X X   X X       X X X X         X X       X     X X   X   X   X   X X   X   X X X   X X X X   X
XXX XXXXX X XXXXX XXXXX XXX XXX X X XXXXX X XXX X XXX X XXX X X XXXXXXXXXXX X XXXXXXX X XXX X XXXXX XXXXXXX XXX XXXXXXXXX X XXXXXXX X X X XXXXX XXXXX X XXX XXXXX X X XXXXX XXXXXXXXX X XXXXXXXXXXX XXXXXXX XXX XXX X XXXXXXXXX XXX XXXXXXXXX XXXXXXXXX XXXXXXX XXX XXXXXXX XXXXXXXXX XXX X X XXX X X X XXX X
X     X X   X   X X   X   X   X X X X   X X X   X   X   X   X   X   X   X   X X     X X   X   X X   X     X   X         X   X   X   X X X       X   X X   X     X X X X   X X         X X   X   X   X     X X X   X   X       X   X     X   X   X   X X   X   X   X       X X       X X   X     X X X X   X X
X XXX X XXXXXXX X X X X X XXXXX X XXX X X X X XXXXX XXXXX XXXXXXX XXX X X XXX X XXX XXXXX X XXX X X X XXX XXX X XXXXXXX XXXXX X X XXX X XXX XXXXX X XXXXX XXXXX X X X X X X X XXXXXXXXX X XXX X X XXX XXX X X XXX XXXXX XXXXX X X XXXXX XXX XXX X X X XXX X XXX X XXXXX XXX XXXXX X X X XXXXXXXXX X X XXX X X
X   X X         X X X X X   X   X     X   X X     X X X   X           X X   X X X         X X   X X X   X X   X X     X       X X     X X   X     X     X   X X X   X   X   X   X       X     X   X   X X X X X   X     X X   X X     X   X   X   X X   X X X   X   X X X   X     X   X X   X   X   X X X X X
XXX X XXX XXX XXX X X XXXXX X XXXXXXX XXXXX XXXXX X X X XXXXXXXXXXX XXX XXX X X XXXXXXXXXXX X X X XXXXX X X XXX X XXX XXX XXXXX XXX XXX X XXX XXXXXXXXX XXX X X XXXXXXXXXXX XXXXXXX XXX XXXXXXXXXXX XXX X X X X XXX XXXXX X XXX X XXXXXXX X X XXXXX XXX X X X XXX X X X X XXX XXXXXXXXX X X X X XXXXX X X X X
X   X     X   X   X X       X       X     X     X X   X X         X   X X   X X     X   X   X X X   X   X X X   X   X   X X     X   X   X   X X     X     X X X   X       X   X     X X X   X       X   X   X X X     X       X X       X   X   X X X   X X   X   X X X X     X       X   X X X   X   X   X X
X XXXXXXX XXXXX XXX X XXXXXXXXXXXXX XXXXX XXXXXXX XXX X X XXXXXXX XXXXX X XXX XXXXX X X X XXXXX XXX X XXX X XXXXXXX XXX XXX XXX X XXX XXXXXXX X XXX X XXX X X XXX XXXXX X XXX X XXXXX X X X X XXXXXXX XXXXXXX X XXXXX XXXXXXX X XXXXX XXXXXXXXX X X X X X XXXXX XXX X X XXXXXXX XXXXX XXXXX X XXX X XXX XXX X
X   X     X     X   X X           X X             X   X X X X     X     X     X X   X X X         X X   X X         X X X   X   X X X       X X X X X X X X X   X     X X   X X   X X   X X   X     X         X     X     X   X     X     X     X X X X X       X     X     X X X   X       X   X   X   X   X
XXX XXXXXXX XXXXXXX XXX XXXXX X XXX XXXXXXXXXXX XXXXXXX X X X XXXXX XXX XXXXXXX X X X X XXXXXXXXX X XXX X XXXXXXXXXXX X X XXX XXX X XXXXXXX X X X X X X X X XXX XXXXX X XXX X XXX X X XXX XXXXX XXX X XXX XXXXXXXXX XXX X XXX XXXXXXX XXX X XXXXX X X X XXXXXXXXX XXXXXXX X X X XXX XXXXXXXXXXX XXXXX XXX X X
X   X     X X     X       X   X X   X     X X   X       X X X   X   X X X       X X X X X       X X     X                 X   X   X       X X X X   X X X X       X   X X X       X   X   X   X   X X   X X   X   X   X X   X       X   X X X     X X X     X   X   X     X   X   X           X     X   X X X
X XXX XXX X X XXX XXXXXXXXX XXX X XXX XXX X X XXX XXXXXXX X XXX X X X X X XXXXXXX X X X X XXXXX XXX XXXXXXXXXXXXXXX XXXXXXXXXXX XXX XXX X X X X XXX X X X XXXXXXX X XXX X XXXXXXXXXXXXX XXX X X X X XXX X X X X X XXX X XXX XXXXXXX X XXX X XXX XXX X XXXXXXX X X XXX XXXXXXXXXXX X X XXXXXXX X XXX XXX XXX X
X   X X X X X X   X     X   X   X       X X X X X     X   X   X X X X X X X       X X X   X   X   X           X   X   X X       X   X X X X   X   X X X X   X X   X X X   X   X       X X   X   X X X   X X X   X X   X   X X     X X X   X X   X   X X     X X   X   X           X X X     X X   X   X     X
XXX X X X X X X XXX XXX X XXX XXXXXXXXXXX X X X XXXXX X XXX XXX XXX X X X X XXXXXXX X XXXXX X XXX XXXXXXXXX XXX X XXX X X XXXXXXXXX X X XXXXXXXXX X X X XXX X X XXX X X XXX X X XXXXX X XXX XXXXX XXX XXX X XXXXX X XXXXXXX XXXXX X XXX X X X X X XXX X XXX X XXXXX XXX XXXXXXXXXXXXX X X XXX X XXXXX XXXXX X
X   X X X X   X   X X   X X   X           X         X X X           X X X X   X X   X   X   X X X         X X   X   X   X X       X   X           X X X       X   X X   X   X   X   X X   X     X       X X   X   X X       X   X X X   X X X X X X X   X X   X   X     X     X       X X X   X X     X   X X
X XXX X X XXXXXXX X X XXX X XXX XXXXX XXXXXXXXX XXXXX X XXXXXXXXXXXXX X X XXX X X XXXXX X XXX X XXXXXXXXX XXX XXXXX XXXXX XXXXX X XXXXXXX XXXXXXXXX X XXXXX XXXXX X X XXX XXXXXXXXX X XXX XXXXX XXXXXXXXX X XXX X X XXX XXXXX X X X X XXXXX X X X X X XXX XXXXX X XXXXXXXXX X X XXXXXXX XXX XXXXX XXXXX X X X
X   X X X       X   X   X X   X   X   X       X X   X X       X       X     X X   X     X X X X   X     X   X X     X     X     X X   X   X     X   X X   X X   X X X   X X   X     X   X X X   X   X     X X   X X   X   X   X   X X         X X X X   X     X X   X       X X     X X     X     X X   X X X
X X X X XXX XXXXXXXXXXX X XXX XXX XXXXX XXXXX XXX X X XXXXXXX X XXXXXXXXXXX X XXXXX XXXXX X X X X XXXXX XXX X X XXXXX XXXXX XXXXX X X X XXX X XXX XXX X X XXX X X X XXXXX X X XXX X X XXX X X XXXXX X XXXXX X XXXXXXX XXX X XXXXXXX XXXXXXXXXXXXX X XXX XXX X X XXX XXXXX XXX XXXXX X X XXXXX XXXXX X XXX X X
X X       X               X     X           X     X           X             X             X     X         X   X             X       X   X   X       X   X     X   X         X     X X     X         X       X             X                       X         X   X         X         X         X         X   K
XXXXXXXXXXXXXXXXXXXXXXXXXXXXXXXXXXXXXXXXXXXXXXXXXXXXXXXXXXXXXXXXXXXXXXXXXXXXXXXXXXXXXXXXXXXXXXXXXXXXXXXXXXXXXXXXXXXXXXXXXXXXXXXXXXXXXXXXXXXXXXXXXXXXXXXXXXXXXXXXXXXXXXXXXXXXXXXXXXXXXXXXXXXXXXXXXXXXXXXXXXXXXXXXXXXXXXXXXXXXXXXXXXXXXXXXXXXXXXXXXXXXXXXXXXXXXXXXXXXXXXXXXXXXXXXXXXXXXXXXXXXXXXXXXXXXXXXXXXXXX
