XXXXXXXXXXXXXXXXXXXXX
P X       X         X
X X XXXXX XXXXX XXX X
X X X   X     X   X X
X XXXXX XXXXX XXX X X
X       X   X     X X
X XXXXX X X XXXXXXX X
X   X X X X X   X   X
X X X X X X X X X XXX
X X         X X   X X
XXX X XXX X X XXXXX X
X   X X   X   X     X
X XXX X X X XXX X X X
X   X   X X     X X X
X X XXX X XXX XXX X X
X X   X X   X       X
X XXX X XXX X X XXX X
X   X       X X   X X
XXX XXXXXXXXX X XXX X
X                   K
XXXXXXXXXXXXXXXXXXXXX
