XXXXXXX
P   X X
X XXX X
X     X
X XXXXX
X     K
XXXXXXX
